/////////////
/$$$$$@$$$$$/
/$$$$$$$$$$$/
/$$$$$$$$$$$/
//////$//////
/$$$$$$$$$$$/
/$$$$$$$$$$$/
/$$$$$$$$$$$/
/$$$$$$M$$$$/
//////#//////
