/////////////////////////////////////////////////////////
/        @       /                                 / ////
/    ////////    /       M                         /$////
/        /       /                /                / ////
/    /// $ //    / ////////////// /   $        $   / ////
/    /   /  /    / /            / /      /////     / ////
/    /// $ //    /       $        /      /////     /$////
/        /       /                /      /////     / ////
/    ////////    / /$          $/ /      /////       ////
/        /       / ////////////// /   $  ///// $   //////
/                /                /                //////
/  /////   ////  /       /        /                //////
/  /          /  /       /        /                //////
/  /          /  /       /        /                //////
/  /          /  /      $/$       /  ////////////////////
/ $/     $    /$ /  ////////////  /            $   // $ /
/  /          /  /      $/$       /                // $ /
/  /          /  /       /        /                // $ /
/  /////   ////  /       /        /    $           // $ /
/                        /        /                ///  /
/                                 /            $   # $ $/
/////////////////////////////////////////////////////////