/////////////
/     @     /
/           /
/           /
////// //////
/           /
/           /
/           /
/     $M    /
//////#//////
