///////////////////////////////////////////////////////////
/ M ///                                                  $/
/   /$///////////////// /////////////////////////////// ///
/   /                                                     /
/   /////         ////                                    /
/       /         //// // ///////     ///////// ////////  /
//////  ///////// //// // /     /     ///     / /      /  /
//////          / //// //    $  /     / $////     ///M /  /
//////////////         //       /     /       / /    ///  /
////////////////       //       /     ///////// ////////  /
/@                     /////// //                         /
////////////////                               /          /
///// /// /// //    ///////////////    / / / / / / / / /  /
/$                      /                      /          /
///// /// /// //    $   /              / / / / / / / / /  /
////////////////   $    /                      /          /
/              /        /     //////   /// /// $ /// ///  /
/  /   /   /   /  ////  /     / #  /           /          /
/      /                /     /    /   / / / / / / / / /  /
/  /$///// /      ////  /     /// //           /          /
/      /                               / / / / / / / / /  /
/  /   /   /   /  ////  /     //// /           /          /
/              /   $$   /     /$   /                      /
///////////////////////////////////////////////////////////