/////////////////////////////////////////////////////////////
/   $    /                                    $    /        /
/        /    $        /                           /     $  /
/        /             / $                         /        /
/        /             /                                    /
/   @    /       ///////////////////////////////////        /
/        /       /                /                /        /
/        /       /      $                      $   /        /
////  /////////  /                /                /        /
/$       /       /                /                /        /
/        /  $    /        //////////////////       /        /
/        /       /        / # //////////   /       / ////////
/        /       /        /   //////////   /       /        /
/       $/       /// //////                /       /      $ /
/        /       /        / M //////////   /       /        /
/        /       /        //////////////   /       /        /
/ $      /       /                         ////  ///        /
/        /     $ /                         /       /        /
/        /       /                         /       /        /
////  ////  ////////////////////////////////       / $      /
/$       /                                         /        /
/        /                        /                //////// /
/        /    $                $  /            $   /        /
/       $/                        /                / $      /
/        ///////////////////////////////////////////        /
/        /$           /$                          $/        /
/$                    /                 /          /      $ /
/        /        $              $      /$                  /
/////////////////////////////////////////////////////////////