///////////////////////////////////////////////////////////
/ M ///  $$$                   $$             $          $/
/   /$///////////////// /////////////////////////////// ///
/   / $                                                   /
/   ///// $  $    ////                                    /
/       /         //// // ///////     ///////// ////////  /
//////  ///////// //// // /     /     ///     / /      /  /
//////          / //// //  $ $  /     / $////     ///M /  /
//////////////         //  $ $  /     /       / /    ///  /
////////////////       //       /     ///////// ////////  /
/@                     /////// //                         /
////////////////                               /          /
/////$///$///$//    ///////////////    / / / / / / / / /  /
/$                      /                 $  $ /  $   $   /
/////$///$///$//    $   / $            / / / / / / / / /  /
////////////////   $    / $                    /          /
/              /        /     //////   /// /// $ /// ///  /
/  / $ / $ /   /  ////  /     / #  /           /          /
/      /                /     /    /   / / / / / / / / /  /
/  /$///// /      ////  /     /// //      $  $ /  $   $   /
/      /                               / / / / / / / / /  /
/  / $ / $ /   /  ////  /     //// /           /          /
/              /   $$   /     /$   /                      /
///////////////////////////////////////////////////////////