/////////////
/     @     /
/           /
/           /
////// //////
/           /
/           /
/           /
/     $     /
//////#//////
