/////////////
/     @     /
/           /
/           /
//////$//////
/     $     /
/   $$$     /
/   $$$     /
/   $$$M    /
//////#//////
