////////////////////////////////////////////////////
/           /            / $                    $  /
/@                  $    /                         /
/           /            /                         /
//////////////////// /////              #          /
/     /                  /                         /
/$                       /                         /
/$                                                 /
/     /                  / $                    $  /
////////////////////////////////////////////////////